abase	negative
abasement	negative
abash	negative
aberration	negative
aberration	negative
abhor	negative
abhor	negative
abhorred	negative
abhorrence	negative
abhorrent	negative
abhorrently	negative
abhors	negative
abhors	negative
abidance	positive
abidance	positive
abide	positive
abject	negative
abjectly	negative
abominable	negative
abominably	negative
abominate	negative
abomination	negative
abrasive	negative
abscond	negative
absent-minded	negative
absolve	positive
absurd	negative
absurdity	negative
absurdly	negative
absurdness	negative
abuse	negative
abusive	negative
abysmal	negative
abysmally	negative
abyss	negative
accede	positive
acclaim	positive
acclaim	positive
acclaimed	positive
acclamation	positive
accolade	positive
accolades	positive
accursed	negative
accusation	negative
accusation	negative
accusations	negative
accusations	negative
accuse	negative
accuses	negative
accusing	negative
accusingly	negative
acerbate	negative
acerbic	negative
acerbically	negative
ache	negative
acrid	negative
acridly	negative
acridness	negative
acrimonious	negative
acrimoniously	negative
acrimony	negative
acumen	positive
adamant	negative
adamantly	negative
admirable	positive
admirer	positive
admirable	positive
admirably	positive
admiration	positive
admire	positive
admiring	positive
admiringly	positive
admit	positive
admittedly	positive
admonish	negative
admonisher	negative
admonishingly	negative
admonishment	negative
admonition	negative
adorable	positive
adore	positive
adored	positive
adorer	positive
adorer	positive
adoring	positive
adoringly	positive
adroit	positive
adroitly	positive
adulate	positive
adulation	positive
adulatory	positive
adulterate	negative
adulterated	negative
adulteration	negative
advantageous	positive
adventuresome	positive
adventurism	positive
adversity	negative
advocate	positive
advocacy	positive
affable	positive
affection	positive
affection	positive
affectionate	positive
affirm	positive
affirmation	positive
affirmation	positive
afflictive	negative
affront	negative
affront	negative
afraid	negative
aggravate	negative
aggravating	negative
aggravation	negative
aggression	negative
aggression	negative
aggressive	negative
aggressiveness	negative
aggressor	negative
aggrieve	negative
aggrieved	negative
aghast	negative
agitate	negative
agitated	negative
agitation	negative
agitator	negative
agonies	negative
agonize	negative
agonizing	negative
agonizing	negative
agonizingly	negative
agony	negative
agree	positive
agreeability	positive
agreeable	positive
agreeableness	positive
agreeably	positive
aimless	negative
alarmed	negative
alarming	negative
alarmingly	negative
alas	negative
allay	positive
allegation	negative
allegations	negative
allegations	negative
allure	positive
allure	positive
alluring	positive
alluringly	positive
ally	positive
almighty	positive
aloof	negative
altruist	positive
altruistic	positive
altruistically	positive
amaze	positive
amazed	positive
amazement	positive
amazing	positive
amazing	positive
amazingly	positive
ambiguous	negative
ambiguity	negative
ambivalence	negative
ambivalent	negative
ambivalent	negative
ameliorate	positive
amenable	positive
amiability	positive
amiabily	positive
amiable	positive
amicability	positive
amicable	positive
amicably	positive
amiss	negative
amour	positive
amuse	positive
amusement	positive
amusement	positive
amusing	positive
amusing	positive
amusingly	positive
anarchism	negative
anarchist	negative
anarchistic	negative
anarchy	negative
angelic	positive
anger	negative
anger	negative
anger	negative
angrily	negative
angriness	negative
angry	negative
anguish	negative
anguish	negative
annihilate	negative
annihilation	negative
animosity	negative
annoy	negative
annoyance	negative
annoyed	negative
annoying	negative
annoying	negative
annoyingly	negative
antagonism	negative
antagonistic	negative
antagonize	negative
anti-	negative
anti-American	negative
anti-American	negative
anti-Israeli	negative
anti-Israeli	negative
anti-Semites	negative
anti-Semites	negative
anti-US	negative
anti-US	negative
anti-occupation	negative
anti-occupation	negative
anti-proliferation	negative
anti-proliferation	negative
anti-social	negative
anti-white	negative
anti-white	negative
antipathy	negative
antiquated	negative
antithetical	negative
antithetical	negative
anxieties	negative
anxiety	negative
anxious	negative
anxiously	negative
anxiousness	negative
apathetic	negative
apathetic	negative
apathetically	negative
apathy	negative
ape	negative
apocalypse	negative
apocalyptic	negative
apologist	negative
apologist	negative
apologists	negative
apologists	negative
apostle	positive
apostle	positive
apotheosis	positive
apotheosis	positive
appal	negative
appall	negative
appall	negative
appall	negative
appalled	negative
appalling	negative
appallingly	negative
appealing	positive
applaud	positive
appreciate	positive
appreciation	positive
appreciation	positive
appreciative	positive
appreciatively	positive
appreciativeness	positive
apprehension	negative
apprehensions	negative
apprehensions	negative
apprehensive	negative
apprehensive	negative
apprehensively	negative
arbitrary	negative
arcane	negative
archaic	negative
ardent	positive
ardently	positive
ardor	positive
arduous	negative
arduously	negative
argue	negative
argumentative	negative
arousal	positive
arouse	positive
arousing	positive
arresting	positive
arrogance	negative
arrogant	negative
arrogant	negative
arrogantly	negative
arrogantly	negative
articulate	positive
ascendant	positive
ascendant	positive
ascertainable	positive
ascertainable	positive
ashamed	negative
asinine	negative
asininely	negative
asinininity	negative
askance	negative
asperse	negative
aspersion	negative
aspersions	negative
aspiration	positive
aspirations	positive
aspirations	positive
aspire	positive
assassin	negative
assent	positive
assertions	positive
assertions	positive
assiduous	positive
assiduously	positive
assure	positive
assuredly	positive
astonish	positive
astonished	positive
astonishing	positive
astonishing	positive
astonishingly	positive
astonishment	positive
astound	positive
astounded	positive
astounding	positive
astounding	positive
astounding	positive
astoundingly	positive
astute	positive
astutely	positive
asunder	negative
atrocious	negative
atrocities	negative
atrocity	negative
atrophy	negative
attentive	positive
attest	positive
attraction	positive
attraction	positive
attractive	positive
attractive	positive
attractively	positive
audacious	negative
audaciously	negative
audaciousness	negative
audacity	negative
auspicious	positive
austere	negative
autocrat	negative
autocratic	negative
autocratic	negative
autocratic	negative
avalanche	negative
avalanche	negative
avarice	negative
avaricious	negative
avariciously	negative
avenge	negative
aver	positive
averse	negative
aversion	negative
avid	positive
avidly	positive
awe	positive
awe	positive
awed	positive
awesome	positive
awesome	positive
awesomely	positive
awesomeness	positive
awestruck	positive
awful	negative
awful	negative
awfully	negative
awfulness	negative
awfulness	negative
awkward	negative
awkwardness	negative
ax	negative
babble	negative
backbite	negative
backbiting	negative
backward	negative
backwardness	negative
bad	negative
badly	negative
baffle	negative
baffled	negative
bafflement	negative
baffling	negative
bait	negative
balk	negative
banal	negative
banal	negative
banalize	negative
bane	negative
banish	negative
banish	negative
banishment	negative
barbarian	negative
barbarian	negative
barbaric	negative
barbarically	negative
barbarity	negative
barbarity	negative
barbarous	negative
barbarous	negative
barbarously	negative
bargain	positive
bargain	positive
barren	negative
baseless	negative
bashful	negative
bastard	negative
bastard	negative
battle-lines	negative
battle-lines	negative
battleground	negative
battleground	negative
batty	negative
beast	negative
beast	negative
beastly	negative
beatify	positive
beauteous	positive
beautiful	positive
beautiful	positive
beautifully	positive
beautify	positive
beauty	positive
bedlam	negative
bedlamite	negative
befit	positive
befitting	positive
befoul	negative
befriend	positive
beg	negative
beggarly	negative
begging	negative
begging	negative
beguile	negative
belabor	negative
beleaguer	negative
belie	negative
believable	positive
belittle	negative
belittled	negative
belittling	negative
bellicose	negative
bellicose	negative
belligerence	negative
belligerent	negative
belligerent	negative
belligerently	negative
beloved	positive
bemoan	negative
bemoaning	negative
bemused	negative
beneficent	positive
beneficial	positive
beneficially	positive
beneficiary	positive
beneficiary	positive
benevolence	positive
benevolent	positive
berate	negative
bereave	negative
bereavement	negative
bereft	negative
berserk	negative
beseech	negative
besmirch	negative
best	positive
best-known	positive
best-performing	positive
bestial	negative
betray	negative
betrayal	negative
betrayals	negative
betrayer	negative
better	positive
better-known	positive
better-than-expected	positive
bewail	negative
bewilder	negative
bewildered	negative
bewildering	negative
bewildering	negative
bewilderingly	negative
bewilderment	negative
bewitch	negative
bias	negative
bias	negative
bias	negative
biased	negative
biased	negative
biases	negative
biases	negative
bicker	negative
bickering	negative
bitch	negative
bitchy	negative
biting	negative
bitingly	negative
bitter	negative
bitterly	negative
bitterness	negative
bizarre	negative
blab	negative
blabber	negative
blah	negative
blame	negative
blame	negative
blame	negative
blameless	positive
blameworthy	negative
bland	negative
blandish	negative
blaspheme	negative
blasphemous	negative
blasphemous	negative
blasphemy	negative
blasted	negative
blatant	negative
blatantly	negative
blather	negative
bleak	negative
bleakly	negative
bleakness	negative
bless	positive
blessing	positive
blessing	positive
blinding	negative
blinding	negative
blindingly	negative
blindside	negative
bliss	positive
blissful	positive
blissfully	positive
blister	negative
blistering	negative
blithe	positive
bloated	negative
blockhead	negative
bloodshed	negative
bloodthirsty	negative
blunder	negative
blunder	negative
blundering	negative
blunders	negative
blunt	negative
blurt	negative
boast	positive
boast	negative
boastful	negative
boggle	negative
bogus	negative
boil	negative
boiling	negative
boisterous	negative
bold	positive
boldly	positive
boldness	positive
bolster	positive
bombardment	negative
bombardment	negative
bombastic	negative
bondage	negative
bonkers	negative
bonkers	negative
bonny	positive
bore	negative
boredom	negative
boring	negative
boring	negative
botch	negative
bother	negative
bother	negative
bothersome	negative
boundless	positive
bountiful	positive
bowdlerize	negative
braggart	negative
braggart	negative
bragger	negative
bragger	negative
brains	positive
brains	positive
brainwash	negative
brainy	positive
brash	negative
brashly	negative
brashness	negative
brat	negative
bravado	negative
brave	positive
brave	positive
bravery	positive
bravery	positive
brazen	negative
brazenly	negative
brazenly	negative
brazenness	negative
brazenness	negative
break-point	negative
break-point	negative
breathlessness	positive
breathlessness	positive
breathtaking	positive
breathtakingly	positive
brilliant	positive
brilliant	positive
brilliantly	positive
brimstone	negative
brimstone	negative
bristle	negative
broken-hearted	negative
brood	negative
brook	positive
browbeat	negative
brusque	negative
brutal	negative
brutalising	negative
brutalising	negative
brutalities	negative
brutalities	negative
brutality	negative
brutalize	negative
brutalizing	negative
brutally	negative
brute	negative
brutish	negative
bullies	negative
bullies	negative
bully	negative
bully	negative
bullyingly	negative
bungle	negative
bungler	negative
burden	negative
burden	negative
burdensome	negative
burdensome	negative
burdensomely	negative
burn	negative
busybody	negative
butchery	negative
byzantine	negative
cackle	negative
cajole	negative
calamities	negative
calamitous	negative
calamitously	negative
calamity	negative
calamity	negative
callous	negative
calming	positive
calumniate	negative
calumniation	negative
calumnies	negative
calumnious	negative
calumniously	negative
calumny	negative
candid	positive
candor	positive
cannibal	negative
cannibalize	negative
capricious	negative
capriciously	negative
capriciousness	negative
captivate	positive
captivating	positive
captivation	positive
carefree	positive
careless	negative
carelessness	negative
caricature	negative
carnage	negative
carp	negative
cartoonish	negative
castigate	negative
cataclysm	negative
cataclysmal	negative
cataclysmic	negative
cataclysmically	negative
catalyst	positive
catalyst	positive
catastrophe	negative
catastrophe	negative
catastrophes	negative
catastrophic	negative
catastrophic	negative
catastrophically	negative
catchy	positive
caustic	negative
caustically	negative
cautionary	negative
celebrate	positive
celebrated	positive
celebration	positive
celebratory	positive
censure	negative
censure	negative
censure	negative
chafe	negative
chaff	negative
chagrin	negative
chagrin	negative
chaos	negative
chaotic	negative
charisma	negative
charismatic	positive
charm	positive
charm	positive
charm	positive
charming	positive
charming	positive
charmingly	positive
chaste	positive
chasten	negative
chastise	negative
chastisement	negative
chatter	negative
chatterbox	negative
cheapen	negative
cheap	negative
cheat	negative
cheat	negative
cheater	negative
cheer	positive
cheer	positive
cheery	positive
cheerful	positive
cheerless	negative
cherish	positive
cherished	positive
cherub	positive
chic	positive
chide	negative
childish	negative
chit	negative
chivalry	positive
chivalrous	positive
civility	positive
clear-cut	positive
clearer	positive
clearer	positive
clearly	positive
clever	positive
cliche	negative
cliched	negative
closeness	positive
closeness	positive
cloud	negative
clout	positive
clout	positive
clumsy	negative
coax	positive
cocky	negative
coerce	negative
coercion	negative
coercive	negative
cogent	positive
coherence	positive
coherence	positive
coldly	negative
collude	negative
collusion	negative
comely	positive
comforting	positive
commend	positive
commendable	positive
commendably	positive
commiserate	negative
commotion	negative
commotion	negative
compassion	positive
compassionate	positive
compel	negative
compelling	positive
compelling	positive
compensate	positive
complacent	negative
complacent	negative
complain	negative
complaining	negative
complaining	negative
complaint	negative
complaints	negative
complaints	negative
complement	positive
compliant	positive
compliant	positive
complicit	negative
compliment	positive
complimentary	positive
compulsion	negative
compulsive	negative
comrades	positive
comrades	positive
concede	negative
conceit	negative
conceited	negative
conceivable	positive
conceivable	positive
concern	negative
concern	negative
concerned	negative
concerns	negative
concerns	negative
conciliate	positive
conciliatory	positive
concur	positive
condescend	negative
condescending	negative
condescendingly	negative
condescension	negative
condemn	negative
condemn	negative
condemnable	negative
condemnation	negative
condolence	negative
condolences	negative
condolences	negative
condone	positive
confess	negative
confession	negative
confessions	negative
confessions	negative
confidence	positive
confidence	positive
confident	positive
confrontation	negative
confrontation	negative
confuse	negative
confused	negative
confusing	negative
confusing	negative
confusion	negative
confusion	negative
confute	positive
congenial	positive
congratulate	positive
congratulations	positive
congratulations	positive
congratulatory	positive
conscientious	positive
consensus	positive
consent	positive
considerate	positive
conspicuous	negative
conspicuous	negative
conspicuously	negative
conspirator	negative
conspirator	negative
conspiratorial	negative
conspire	negative
constancy	positive
consternation	negative
consummate	positive
contempt	negative
contemptible	negative
contemptuous	negative
contemptuously	negative
contend	negative
content	positive
contention	negative
contentment	positive
contentious	negative
contentious	negative
contort	negative
contortions	negative
contortions	negative
contradict	negative
contradiction	negative
contradictory	negative
contrariness	negative
contrary	negative
contravene	negative
contrive	negative
contrived	negative
convenient	positive
conveniently	positive
convincing	positive
convincing	positive
convincingly	positive
convoluted	negative
cornerstone	positive
cornerstone	positive
correctly	positive
corrupt	negative
corrupt	negative
corruption	negative
counterproductive	negative
coupists	negative
coupists	negative
courage	positive
courage	positive
courageous	positive
courageously	positive
courageousness	positive
court	positive
courteous	positive
courtesy	positive
courtly	positive
covetous	negative
covetous	negative
coward	negative
cowardly	negative
cozy	positive
crafty	negative
cranky	negative
crass	negative
crave	positive
craven	negative
cravenly	negative
craving	positive
craze	negative
crazily	negative
craziness	negative
crazy	negative
creative	positive
credence	positive
credence	positive
credible	positive
credulous	negative
cringe	negative
cripple	negative
crippling	negative
critic	negative
critical	negative
criticism	negative
criticism	negative
criticisms	negative
criticisms	negative
criticize	negative
critics	negative
critics	negative
crook	negative
crooked	negative
cross	negative
cruel	negative
cruelties	negative
cruelty	negative
crusade	positive
crusade	positive
crusader	positive
cry	negative
culpable	negative
cuplrit	negative
cumbersome	negative
cure-all	positive
cure-all	positive
curious	positive
curiously	positive
curse	negative
curse	negative
cursed	negative
cursed	negative
curses	negative
cuss	negative
cute	positive
cutthroat	negative
cynical	negative
cynicism	negative
damn	negative
damn	negative
damn	negative
damnable	negative
damnably	negative
damnation	negative
damned	negative
damning	negative
dangerousness	negative
dangerousness	negative
dangle	negative
dare	positive
daring	positive
daringly	positive
darling	positive
darn	negative
dashing	positive
dastard	negative
dastardly	negative
daunt	negative
daunting	negative
dauntingly	negative
dauntless	positive
dawdle	negative
daydream	positive
daydreamer	positive
daze	negative
dazed	negative
dazzle	positive
dazzled	positive
dazzling	positive
deadbeat	negative
deadlock	negative
deadlock	negative
deadweight	negative
dear	positive
dearth	negative
debacle	negative
debase	negative
debasement	negative
debaser	negative
debatable	negative
debate	negative
debauch	negative
debaucher	negative
debauchery	negative
decadence	negative
decadent	negative
decay	negative
decay	negative
decayed	negative
deceit	negative
deceitful	negative
deceitfully	negative
deceitfulness	negative
deceiving	negative
deceive	negative
deceiver	negative
deceivers	negative
deception	negative
deception	negative
deceptive	negative
deceptive	negative
deceptively	negative
declaim	negative
decrepit	negative
decrepitude	negative
decry	negative
dedicated	positive
deepening	negative
deepening	negative
defamation	negative
defamations	negative
defamatory	negative
defame	negative
defective	negative
defender	positive
defender	positive
deference	positive
defiance	negative
defiance	negative
defiant	negative
defiantly	negative
defile	negative
defiler	negative
definitively	positive
defrauding	negative
defrauding	negative
deft	positive
defunct	negative
defy	negative
degenerate	negative
degenerate	negative
degenerately	negative
degeneration	negative
degradation	negative
degrade	negative
degrading	negative
degradingly	negative
dehumanization	negative
dehumanize	negative
deign	negative
deject	negative
dejected	negative
dejectedly	negative
dejection	negative
delectable	positive
delicious	positive
delight	positive
delight	positive
delighted	positive
delightful	positive
delightful	positive
delightfully	positive
delightfulness	positive
delirious	negative
delirium	negative
delude	negative
deluded	negative
delusion	negative
delusion	negative
delusional	negative
delusional	negative
delusions	negative
delusions	negative
demean	negative
demeaning	negative
demise	negative
demon	negative
demonic	negative
demonize	negative
demonize	negative
demoralize	negative
demoralizing	negative
demoralizingly	negative
demystify	positive
denial	negative
denigrate	negative
deny	negative
denounce	negative
denunciate	negative
denunciation	negative
denunciations	negative
deplorable	negative
deplorable	negative
deplorably	negative
deplore	negative
deploring	negative
deploringly	negative
deprave	negative
depraved	negative
depravedly	negative
deprecate	negative
depressed	negative
depressing	negative
depressing	negative
depressingly	negative
deprive	negative
deprived	negative
deride	negative
derision	negative
derisive	negative
derisively	negative
derisiveness	negative
derogatory	negative
desecrate	negative
deserve	positive
deserved	positive
deservedly	positive
deserving	positive
desert	negative
desertion	negative
desiccate	negative
desiccated	negative
desirable	positive
desire	positive
desire	positive
desire	positive
desirous	positive
desolate	negative
desolately	negative
desolation	negative
despair	negative
despair	negative
despairing	negative
despairingly	negative
desperate	negative
desperately	negative
desperation	negative
despicable	negative
despicably	negative
despise	negative
despised	negative
despised	negative
despite	negative
despoil	negative
despoiler	negative
despondence	negative
despondency	negative
despondent	negative
despondently	negative
despot	negative
despotic	negative
despotism	negative
despotism	negative
destabilisation	negative
destabilisation	negative
destinies	positive
destinies	positive
destiny	positive
destitute	negative
destitution	negative
destroyer	negative
destroyer	negative
destructive	negative
desultory	negative
determination	positive
determination	positive
detest	negative
detestable	negative
detestably	negative
detriment	negative
detrimental	negative
devastate	negative
devastated	negative
devastating	negative
devastatingly	negative
devil	negative
devilish	negative
devilishly	negative
devilment	negative
devilry	negative
devious	negative
deviously	negative
deviousness	negative
devoid	negative
devote	positive
devoted	positive
devotee	positive
devotion	positive
dexterous	positive
dexterously	positive
dextrous	positive
diabolic	negative
diabolical	negative
diabolically	negative
diametrically	negative
diatribe	negative
diatribes	negative
difficulty	negative
difficulty	negative
diffidence	negative
diffidence	negative
dignified	positive
dignity	positive
digress	negative
dilapidated	negative
dilly-dally	negative
dim	negative
dire	negative
direly	negative
direness	negative
disaccord	negative
disadvantage	negative
disadvantageous	negative
disadvantageous	negative
disaffect	negative
disaffected	negative
disaffirm	negative
disagree	negative
disagreeable	negative
disagreeably	negative
disagreement	negative
disagreement	negative
disallow	negative
disappoint	negative
disappointed	negative
disappointing	negative
disappointingly	negative
disappointment	negative
disappointment	negative
disapprobation	negative
disapproval	negative
disapproval	negative
disapprove	negative
disapproving	negative
disarray	negative
disarray	negative
disaster	negative
disastrous	negative
disastrously	negative
disavow	negative
disavowal	negative
disbelief	negative
disbelieve	negative
disbeliever	negative
discerning	positive
disclaim	negative
discombobulate	negative
discomfit	negative
discomfititure	negative
disconcert	negative
disconcerted	negative
disconcerting	negative
disconcertingly	negative
disconsolate	negative
disconsolately	negative
disconsolation	negative
discontent	negative
discontent	negative
discontented	negative
discontentedly	negative
discontinuity	negative
discontinuity	negative
discord	negative
discordance	negative
discordant	negative
discountenance	negative
discourage	negative
discouragement	negative
discouraging	negative
discouragingly	negative
discourteous	negative
discourteously	negative
discredit	negative
discriminatory	negative
disdain	negative
disdain	negative
disdainful	negative
disdainfully	negative
disfavor	negative
disgrace	negative
disgrace	negative
disgraced	negative
disgraceful	negative
disgracefully	negative
disgruntle	negative
disgruntled	negative
disgust	negative
disgust	negative
disgusted	negative
disgustedly	negative
disgustful	negative
disgustfully	negative
disgusting	negative
disgustingly	negative
dishearten	negative
disheartening	negative
dishearteningly	negative
dishonest	negative
dishonest	negative
dishonestly	negative
dishonesty	negative
dishonor	negative
dishonor	negative
dishonorable	negative
dishonorablely	negative
disillusion	negative
disillusion	negative
disillusioned	negative
disinclination	negative
disinclined	negative
disingenuous	negative
disingenuously	negative
disinterest	negative
disinterested	negative
dislike	negative
disloyal	negative
disloyal	negative
disloyalty	negative
dismal	negative
dismally	negative
dismalness	negative
dismay	negative
dismay	negative
dismayed	negative
dismaying	negative
dismayingly	negative
dismissive	negative
dismissive	negative
dismissively	negative
disobedience	negative
disobedient	negative
disobey	negative
disown	negative
disorganized	negative
disorient	negative
disoriented	negative
disown	negative
disparage	negative
disparaging	negative
disparagingly	negative
dispirit	negative
dispirited	negative
dispiritedly	negative
dispiriting	negative
displease	negative
displeasing	negative
displeasure	negative
displeasure	negative
disprove	negative
disputable	negative
dispute	negative
dispute	negative
disputed	negative
disquiet	negative
disquieting	negative
disquietingly	negative
disquietude	negative
disregard	negative
disregard	negative
disregardful	negative
disreputable	negative
disrepute	negative
disrespect	negative
disrespectable	negative
disrespectablity	negative
disrespectful	negative
disrespectfully	negative
disrespectfulness	negative
disrespecting	negative
disrespecting	negative
disrupt	negative
disruption	negative
disruption	negative
disruptive	negative
dissatisfaction	negative
dissatisfaction	negative
dissatisfactory	negative
dissatisfied	negative
dissatisfy	negative
dissatisfying	negative
dissemble	negative
dissembler	negative
dissension	negative
dissent	negative
dissent	negative
dissenter	negative
dissention	negative
disservice	negative
disservice	negative
dissidence	negative
dissident	negative
dissident	negative
dissidents	negative
dissidents	negative
dissocial	negative
dissolute	negative
dissonance	negative
dissonant	negative
dissonantly	negative
dissuade	negative
dissuasive	negative
distaste	negative
distasteful	negative
distastefully	negative
distinguished	positive
distort	negative
distortion	negative
distortion	negative
distracting	negative
distraction	negative
distraction	negative
distraught	negative
distraughtly	negative
distraughtness	negative
distress	negative
distressed	negative
distressing	negative
distressingly	negative
distrust	negative
distrustful	negative
distrusting	negative
disturb	negative
disturbed	negative
disturbed-let	negative
disturbed-let	negative
disturbing	negative
disturbingly	negative
disunity	negative
disvalue	negative
divine	positive
divine	positive
divinely	positive
divisive	negative
divisively	negative
divisiveness	negative
dizzy	negative
dizzing	negative
dizzingly	negative
doddering	negative
dodge	positive
dodge	positive
dodgey	negative
dogged	negative
doggedly	negative
dogmatic	negative
doldrums	negative
domination	negative
domination	negative
domineer	negative
domineering	negative
domineering	negative
doom	negative
doomsday	negative
doomsday	negative
dote	positive
dotingly	positive
doubt	negative
doubt	negative
doubtful	negative
doubtfully	negative
doubtless	positive
doubts	negative
doubts	negative
downbeat	negative
downcast	negative
downer	negative
downfall	negative
downfallen	negative
downhearted	negative
downheartedly	negative
downside	negative
drab	negative
draconian	negative
draconic	negative
dragon	negative
dragons	negative
dragons	negative
dragoon	negative
drain	negative
drain	negative
drama	negative
drama	negative
drastic	negative
drastically	negative
dread	negative
dread	negative
dreadful	negative
dreadfully	negative
dreadfulness	negative
dream	positive
dreamland	positive
dreary	negative
drones	negative
drones	negative
drunk	negative
drunkard	negative
drunken	negative
dubious	negative
dubiously	negative
dubitable	negative
dullard	negative
dumb	negative
dumb	negative
dumbfound	negative
dumbfounded	negative
dummy	negative
dunce	negative
dungeon	negative
dungeons	negative
dungeons	negative
dupe	negative
eager	positive
eagerly	positive
eagerness	positive
earnest	positive
earnestly	positive
earnestness	positive
earsplitting	negative
easygoing	positive
ebullience	positive
ebullient	positive
ebulliently	positive
eclectic	positive
ecstasies	positive
ecstasy	positive
ecstatic	positive
ecstatically	positive
edgy	negative
edify	positive
effigy	negative
effortless	positive
effortlessly	positive
effrontery	negative
effusion	positive
effusive	positive
effusively	positive
effusiveness	positive
ego	negative
ego	negative
egocentric	negative
egomania	negative
egotism	negative
egotistical	negative
egotistically	negative
egregious	negative
egregiously	negative
ejaculate	negative
elan	positive
elated	positive
elatedly	positive
elation	positive
election-rigger	negative
election-rigger	negative
electrification	positive
electrification	positive
elegance	positive
elegant	positive
elegantly	positive
eloquence	positive
eloquent	positive
eloquently	positive
emaciated	negative
emasculate	negative
embarrass	negative
embarrassing	negative
embarrassingly	negative
embarrassment	negative
embellish	positive
embrace	positive
embroil	negative
embroiled	negative
embroilment	negative
eminence	positive
eminent	positive
emotional	negative
empathize	negative
empathy	negative
emphatic	negative
emphatically	negative
emptiness	negative
emptiness	negative
enchant	positive
enchanted	positive
enchanting	positive
enchantingly	positive
encouragement	positive
encouragement	positive
encouraging	positive
encouraging	positive
encouragingly	positive
endanger	negative
endear	positive
endearing	positive
endorse	positive
endorsement	positive
endorsement	positive
endorser	positive
endurable	positive
endure	positive
enduring	positive
enervate	negative
enfeeble	negative
enflame	negative
engaging	positive
engrossing	positive
enjoin	negative
enjoyable	positive
enjoyably	positive
enjoyment	positive
enmity	negative
ennoble	positive
enormities	negative
enormity	negative
enormous	negative
enormously	negative
enrage	negative
enraged	negative
enrapt	positive
enraptured	positive
enslave	negative
entertaining	positive
enthral	positive
enthrall	positive
enthralled	positive
enthuse	positive
enthusiasm	positive
enthusiast	positive
enthusiastic	positive
enthusiastically	positive
entice	positive
enticing	positive
enticingly	positive
entranced	positive
entrancing	positive
entrap	negative
entrapment	negative
entreat	positive
entreatingly	positive
enviable	positive
enviably	positive
envious	negative
enviously	negative
enviousness	negative
envy	negative
envy	negative
epic	positive
epitome	positive
equivocal	negative
err	negative
erratic	negative
erratically	negative
erroneous	negative
erroneous	negative
erroneously	negative
erudite	positive
eschew	negative
especially	positive
esteem	positive
esteem	positive
estranged	negative
eternity	positive
eternity	positive
ethical	positive
eulogize	positive
euphoria	positive
euphoric	positive
euphorically	positive
everlasting	positive
evidently	positive
evil	negative
evil	negative
evildoer	negative
evils	negative
evils	negative
eviscerate	negative
evocative	positive
exacerbate	negative
exaggerate	negative
exaggeration	negative
exaggeration	negative
exalt	positive
exalt	positive
exaltation	positive
exalted	positive
exaltedly	positive
exalting	positive
exaltingly	positive
exasperate	negative
exasperation	negative
exasperating	negative
exasperatingly	negative
exceed	positive
exceeding	positive
exceedingly	positive
excel	positive
excellence	positive
excellency	positive
excellent	positive
excellently	positive
exceptional	positive
exceptionally	positive
excessive	negative
excessively	negative
excited	positive
excitedly	positive
excitedness	positive
excitement	positive
exciting	positive
excitingly	positive
exclaim	negative
excoriate	negative
excruciating	negative
excruciatingly	negative
excusable	positive
excusable	positive
execrate	negative
exemplar	positive
exemplary	positive
exhilarate	positive
exhilarating	positive
exhilaratingly	positive
exhilaration	positive
exhort	negative
exonerate	positive
exorbitant	negative
exorbitantance	negative
exorbitantly	negative
expansive	positive
expertly	positive
expire	negative
explicit	positive
explicitly	positive
exploit	negative
exploitation	negative
exploitation	negative
expunge	negative
exquisite	positive
exquisitely	positive
exterminate	negative
extermination	negative
extol	positive
extoll	positive
extortion	negative
extraordinarily	positive
extraordinary	positive
extravagance	negative
extravagant	negative
extravagantly	negative
extreme	negative
extremely	negative
exuberance	positive
exuberant	positive
exuberantly	positive
exult	positive
exultation	positive
exultingly	positive
fabrication	negative
fabulous	positive
fabulously	positive
facetious	negative
facetiously	negative
failing	negative
fainthearted	negative
faith	positive
faith	positive
faithful	positive
faithful	positive
faithfully	positive
faithfulness	positive
faithless	negative
fake	negative
fallacies	negative
fallacies	negative
fallacious	negative
fallaciously	negative
fallaciousness	negative
fallacy	negative
fallout	negative
false	negative
false	negative
falsehood	negative
falsely	negative
falsify	negative
falter	negative
fame	positive
famed	positive
famine	negative
famished	negative
famously	positive
fanatic	negative
fanatical	negative
fanatically	negative
fanaticism	negative
fanatics	negative
fanciful	negative
fancy	positive
fancy	positive
fanfare	positive
fanfare	positive
fantastic	positive
fantastically	positive
fantasy	positive
fantasy	positive
far-fetched	negative
farfetched	negative
farce	negative
farcical	negative
farcical-yet-provocative	negative
farcically	negative
fascinate	positive
fascinating	positive
fascinatingly	positive
fascination	positive
fascism	negative
fascism	negative
fascist	negative
fashionable	positive
fashionably	positive
fastidious	negative
fastidiously	negative
fastuous	negative
fatalistic	negative
fatalistically	negative
fateful	negative
fatefully	negative
fathomless	negative
fatuity	negative
fatuous	negative
fatuously	negative
fault	negative
favor	positive
favorable	positive
favorable	positive
favorite	positive
fawningly	negative
favour	positive
fear	negative
fear	negative
fearful	negative
fearfully	negative
fearless	positive
fearlessly	positive
fears	negative
fears	negative
fearsome	negative
featly	positive
feckless	negative
feebleminded	negative
feisty	positive
feisty	positive
felicitate	positive
felicitous	positive
felicity	positive
fell	negative
ferocious	negative
ferociously	negative
ferocity	negative
fervent	positive
fervently	positive
fervid	positive
fervidly	positive
fervor	positive
festive	positive
fetid	negative
fiasco	negative
fib	negative
fib	negative
fibber	negative
fickle	negative
fictitious	negative
fidelity	positive
fidget	negative
fidgety	negative
fiend	negative
fiendish	negative
filth	negative
filthy	negative
finely	positive
first-rate	positive
fit	positive
fitting	positive
flabbergast	negative
flabbergasted	negative
flagrant	negative
flagrantly	negative
flak	negative
flak	negative
flat-out	negative
flatter	positive
flattering	positive
flatteringly	positive
flaunt	negative
flawless	positive
flawlessly	positive
fleer	negative
flexible	positive
flighty	negative
flimflam	negative
flirt	negative
flirty	negative
floored	negative
flounder	negative
floundering	negative
flourish	positive
flourishing	positive
flout	negative
foe	negative
fond	positive
fondly	positive
fondness	positive
fool	negative
foolhardy	negative
foolish	negative
foolishly	negative
foolishness	negative
forbid	negative
forbidden	negative
foreboding	negative
forebodingly	negative
foremost	positive
foresight	positive
forgave	positive
forget	negative
forgetful	negative
forgetfully	negative
forgetfulness	negative
forgive	positive
forgiven	positive
forgiveness	positive
forgiving	positive
forgivingly	positive
forlorn	negative
forlornly	negative
formidable	negative
forsake	negative
forsaken	negative
forswear	negative
fortitude	positive
fortuitous	positive
fortuitously	positive
fortunate	positive
fortunately	positive
fortune	positive
fortune	positive
foul	negative
foul	negative
foully	negative
foulness	negative
fractious	negative
fractiously	negative
fragrant	positive
frank	positive
frantic	negative
frantically	negative
franticly	negative
fraternize	negative
fraught	negative
fraught	negative
freak	negative
freak	negative
freakish	negative
freakish	negative
freakish	negative
freakishly	negative
frazzle	negative
frazzle	negative
frazzled	negative
frenetic	negative
frenetically	negative
frenzied	negative
frenzy	negative
fret	negative
fretful	negative
friction	negative
friction	negative
frictions	negative
frictions	negative
friendliness	positive
friendliness	positive
friendly	positive
friggin	negative
fright	negative
fright	negative
frighten	negative
frightening	negative
frighteningly	negative
frighteningly	negative
frightful	negative
frightfully	negative
frivolous	negative
frolic	positive
frown	negative
frown	negative
fruitless	negative
fruitlessly	negative
fun	negative
frustrate	negative
frustrated	negative
frustrating	negative
frustrating	negative
frustratingly	negative
frustration	negative
fudge	negative
fudge	negative
fudge	negative
fulminate	negative
fume	negative
fun	positive
funny	positive
funny	positive
furious	negative
furiously	negative
furor	negative
fury	negative
fuss	negative
fuss	negative
fuss	negative
fustigate	negative
fussy	negative
fusty	negative
futile	negative
futilely	negative
futility	negative
gabble	negative
gaff	negative
gaffe	negative
gaiety	positive
gaily	positive
gainful	positive
gainfully	positive
gainsay	negative
gainsayer	negative
gaga	negative
gaggle	negative
gall	negative
gallant	positive
gallantly	positive
galling	negative
gallingly	negative
galore	positive
gape	negative
garish	negative
gasp	negative
gasp	negative
gauche	negative
gaudy	negative
gawk	negative
gawky	negative
geezer	negative
generosity	positive
generous	positive
generously	positive
genius	positive
genocide	negative
genocide	negative
get-rich	negative
get-rich	negative
ghastly	negative
gibber	negative
gibberish	negative
gibe	negative
giddy	positive
gifted	positive
glad	positive
gladden	positive
gladly	positive
gladness	positive
glamorous	positive
glare	negative
glare	negative
glaring	negative
glaringly	negative
glee	positive
gleeful	positive
gleefully	positive
glib	negative
glibly	negative
glimmer	positive
glimmer	positive
glimmer	positive
glimmering	positive
glisten	positive
glisten	positive
glistening	positive
glitter	positive
glitter	positive
gloatingly	negative
gloom	negative
gloomy	negative
glorify	positive
glorious	positive
gloriously	positive
glory	positive
glory	positive
gloss	negative
glossy	positive
glow	positive
glower	negative
glowing	positive
glowingly	positive
glum	negative
goad	negative
goading	negative
god-awful	negative
god-given	positive
goddam	negative
goddamn	negative
godlike	positive
goodness	positive
goodwill	positive
goodwill	positive
goof	negative
goof	negative
gorgeous	positive
gorgeously	positive
gossip	negative
gossip	negative
gossip	negative
grace	positive
graceful	positive
gracefully	positive
graceless	negative
gracelessly	negative
gracious	positive
graciously	positive
graciousness	positive
grandeur	positive
grandiose	negative
grate	negative
grateful	positive
grateful	positive
gratefully	positive
gratification	positive
gratify	positive
gratifying	positive
gratifyingly	positive
grating	negative
gratitude	positive
gratitude	positive
gratuitous	negative
gratuitous	negative
gratuitously	negative
grave	negative
gravely	negative
great	positive
greatest	positive
greatness	positive
greed	negative
greedy	negative
greet	positive
grief	negative
grievance	negative
grievances	negative
grievances	negative
grieve	negative
grieving	negative
grievous	negative
grievously	negative
grim	negative
grimace	negative
grin	positive
grind	negative
grind	negative
gripe	negative
gripe	negative
grisly	negative
grit	positive
grit	positive
grossly	negative
grotesque	negative
grouch	negative
grouchy	negative
groundbreaking	positive
groundbreaking	positive
groundless	negative
grouse	negative
growl	negative
grudge	negative
grudges	negative
grudges	negative
grudging	negative
grudgingly	negative
gruesome	negative
gruesomely	negative
gruff	negative
grumble	negative
guile	negative
guilt	negative
guiltless	positive
guiltily	negative
gullible	negative
gumption	positive
gusto	positive
gutsy	positive
haggard	negative
haggle	negative
hail	positive
halcyon	positive
hale	positive
halfhearted	negative
halfheartedly	negative
hallowed	positive
hallucinate	negative
hallucination	negative
hamper	negative
hamstring	negative
hamstrung	negative
handily	positive
handsome	positive
handy	positive
hanker	positive
hapless	negative
happily	positive
happiness	positive
happy	positive
harangue	negative
harassment	negative
harassment	negative
hard-line	negative
hard-liner	negative
hardball	negative
hardball	negative
hardheaded	negative
hardhearted	negative
hardier	positive
hardier	positive
hardly	negative
hardship	negative
hardships	negative
hardships	negative
harm	negative
harm	negative
harmful	negative
harmless	positive
harmonious	positive
harmoniously	positive
harmonize	positive
harmony	positive
harmony	positive
harms	negative
harms	negative
harpy	negative
harridan	negative
harried	negative
harrow	negative
harsh	negative
harshly	negative
hassle	negative
haste	negative
haste	negative
hasty	negative
hate	negative
hater	negative
hateful	negative
hatefully	negative
hatefulness	negative
haughtily	negative
haughty	negative
hatred	negative
haunting	negative
haven	positive
havoc	negative
hawkish	negative
hawkish	negative
heady	positive
healthful	positive
heartbreak	negative
heartbreaker	negative
heartbreaking	negative
heartbreakingly	negative
hearten	positive
heartening	positive
heartfelt	positive
heartily	positive
heartless	negative
heartrending	negative
heartwarming	positive
heathen	negative
heathen	negative
heavenly	positive
heavily	negative
heavy-handed	negative
heavyhearted	negative
heck	negative
heck	negative
heckle	negative
hedge	negative
hedonistic	negative
heedless	negative
hegemonistic	negative
hegemony	negative
heinous	negative
hell	negative
hell-bent	negative
hellion	negative
herald	positive
heresy	negative
heretic	negative
heretical	negative
hero	positive
heroic	positive
heroic	positive
heroically	positive
heroine	positive
heroize	positive
heros	positive
hesitant	negative
hideous	negative
hideously	negative
hideousness	negative
highlight	positive
highlight	positive
hilarious	positive
hilariously	positive
hilariousness	positive
hilarity	positive
hinder	negative
hindrance	negative
hoard	negative
hoax	negative
hollow	negative
homage	positive
honest	positive
honestly	positive
honesty	positive
honesty	positive
honor	positive
honorable	positive
hoodwink	negative
hope	positive
hope	positive
hope	positive
hopeful	positive
hopefully	positive
hopefulness	positive
hopeless	negative
hopelessly	negative
hopelessness	negative
hopes	positive
hopes	positive
horrendous	negative
horrendously	negative
horrible	negative
horrible	negative
horribly	negative
horrid	negative
horrific	negative
horrifically	negative
horrify	negative
horrify	negative
horrifying	negative
horrifyingly	negative
horror	negative
horrors	negative
hospitable	positive
hostility	negative
hostility	negative
hothead	negative
hotheaded	negative
hotbeds	negative
hotbeds	negative
hubris	negative
huckster	negative
hug	positive
hug	positive
humane	positive
humane	positive
humankind	positive
humble	positive
humbling	negative
humiliate	negative
humiliating	negative
humiliation	negative
humility	positive
humor	positive
humorous	positive
humorously	positive
humour	positive
humour	positive
humourous	positive
hunger	negative
hypocrisy	negative
hypocrite	negative
hypocrites	negative
hypocritical	negative
hypocritically	negative
hysteria	negative
hysteric	negative
hysterical	negative
hysterically	negative
hysterics	negative
ideal	positive
ideal	positive
idealize	positive
ideally	positive
idiocies	negative
idiocy	negative
idiot	negative
idiotic	negative
idiotically	negative
idiots	negative
idol	positive
idol	positive
idolize	positive
idolized	positive
idyllic	positive
ignoble	negative
ignominious	negative
ignominiously	negative
ignominy	negative
ignorance	negative
ignorance	negative
ignorant	negative
ignorant	negative
ill-advised	negative
ill-conceived	negative
ill-fated	negative
ill-favored	negative
ill-mannered	negative
ill-natured	negative
ill-sorted	negative
ill-tempered	negative
ill-treated	negative
ill-treatment	negative
ill-treatment	negative
ill-usage	negative
ill-used	negative
illogic	negative
illogical	negative
illogically	negative
illuminate	positive
illuminati	positive
illuminati	positive
illuminating	positive
illumine	positive
illusion	negative
illusion	negative
illusions	negative
illusions	negative
illusory	negative
illustrious	positive
imaginary	negative
imaginative	positive
imbalance	negative
imbalance	negative
imbecile	negative
imbroglio	negative
immaculate	positive
immaculately	positive
immaterial	negative
imminence	negative
imminent	negative
imminently	negative
immoderate	negative
immoderately	negative
immodest	negative
immoral	negative
immorality	negative
immorally	negative
immovable	negative
impair	negative
impaired	negative
impasse	negative
impassioned	positive
impatience	negative
impatient	negative
impatiently	negative
impeach	negative
impeccable	positive
impeccably	positive
impede	negative
impedance	negative
impediment	negative
impel	positive
impending	negative
impending	negative
impenitent	negative
imperialist	negative
imperil	negative
imperious	negative
imperiously	negative
impertinent	negative
imperturbable	positive
impervious	positive
impetuous	negative
impetuously	negative
impiety	negative
impinge	negative
impious	negative
implacable	negative
implausible	negative
implausibly	negative
implode	negative
impolite	negative
impolitely	negative
impolitic	negative
importunate	negative
importune	negative
impose	negative
imposers	negative
imposers	negative
imposition	negative
imposition	negative
impotent	negative
impotent	negative
impractical	negative
impractical	negative
imprecate	negative
impregnable	positive
impressive	positive
impressively	positive
impressiveness	positive
improbability	negative
improbable	negative
improbably	negative
improper	negative
improperly	negative
impropriety	negative
improvise	positive
imprudence	negative
imprudent	negative
impudence	negative
impudent	negative
impudently	negative
impugn	negative
impulsive	negative
impulsively	negative
impure	negative
impurity	negative
inaccurate	negative
inaccurately	negative
inane	negative
inanely	negative
inappropriate	negative
inappropriately	negative
inapt	negative
inaptitude	negative
inarticulate	negative
inattentive	negative
incapable	negative
incapably	negative
incautious	negative
incendiary	negative
incessant	negative
incessantly	negative
incisive	positive
incisively	positive
incisiveness	positive
incivility	negative
inclination	positive
inclination	positive
inclinations	positive
inclined	positive
incognizant	negative
incoherence	negative
incoherent	negative
incoherently	negative
incommensurate	negative
incompetence	negative
incompetent	negative
incompetently	negative
incomprehensible	negative
incomprehension	negative
inconceivable	negative
inconceivably	negative
incongruous	negative
incongruously	negative
inconsequent	negative
inconsequently	negative
inconsequential	negative
inconsequentially	negative
inconsiderate	negative
inconsiderately	negative
inconsistence	negative
inconsistencies	negative
inconsistencies	negative
inconsolable	negative
inconsolably	negative
inconstant	negative
incontestable	positive
incontrovertible	positive
inconvenience	negative
inconvenience	negative
inconvenient	negative
inconveniently	negative
incorrectly	negative
incorrigible	negative
incorrigibly	negative
incorruptible	positive
incredible	positive
incredibly	positive
incredulous	negative
incredulously	negative
inculcate	negative
indecency	negative
indecent	negative
indecently	negative
indecision	negative
indecisive	negative
indecisively	negative
indecorum	negative
indefatigable	positive
indefensible	negative
indefensible	negative
indelible	positive
indelibly	positive
indelicate	negative
indescribable	positive
indescribably	positive
indestructible	positive
indifference	negative
indifferent	negative
indignant	negative
indignantly	negative
indignation	negative
indignity	negative
indignity	negative
indiscreet	negative
indiscreet	negative
indiscreetly	negative
indiscretion	negative
indiscriminate	negative
indiscriminating	negative
indiscriminately	negative
indispensable	positive
indispensability	positive
indisposed	negative
indisputable	positive
indoctrinate	negative
indoctrination	negative
indoctrination	negative
indolent	negative
indomitable	positive
indomitably	positive
indubitable	positive
indubitably	positive
indulge	negative
indulgence	positive
indulgent	positive
inefficacious	negative
inefficacious	negative
inefficacy	negative
inelegance	negative
inelegant	negative
ineloquent	negative
ineloquently	negative
inept	negative
ineptitude	negative
ineptitude	negative
ineptly	negative
inequality	negative
inequality	negative
inequitable	negative
inequitably	negative
inequities	negative
inequities	negative
inescapable	negative
inescapably	negative
inessential	negative
inestimable	positive
inestimably	positive
inevitable	negative
inevitable	negative
inevitably	negative
inexcusable	negative
inexcusably	negative
inexorable	negative
inexorably	negative
inexpiable	negative
inexplainable	negative
inexplicable	negative
inextricable	negative
inextricably	negative
infallible	positive
infallibly	positive
infallibility	positive
infamous	negative
infamously	negative
infamy	negative
inferior	negative
inferiority	negative
infernal	negative
infidel	negative
infidels	negative
infirm	negative
inflame	negative
inflammatory	negative
inflexible	negative
inflict	negative
infringe	negative
infringement	negative
infringements	negative
infringements	negative
infuriate	negative
infuriated	negative
infuriating	negative
infuriatingly	negative
ingenious	positive
ingeniously	positive
ingenuity	positive
ingenuous	positive
ingenuously	positive
inglorious	negative
ingrate	negative
ingratiate	positive
ingratiating	positive
ingratiatingly	positive
ingratitude	negative
inhospitable	negative
inhospitality	negative
inhuman	negative
inhumane	negative
inhumanity	negative
inimical	negative
inimically	negative
iniquitous	negative
iniquity	negative
injudicious	negative
injustice	negative
injustice	negative
injustices	negative
injustices	negative
innocuous	positive
innocuous	positive
innuendo	negative
innuendo	negative
inoffensive	positive
inopportune	negative
inordinate	negative
inordinately	negative
inquisitive	positive
insane	negative
insanely	negative
insanity	negative
insatiable	negative
insecurity	negative
insecurity	negative
insensitive	negative
insensitively	negative
insensitivity	negative
insensitivity	negative
insidious	negative
insidiously	negative
insight	positive
insight	positive
insightful	positive
insightfully	positive
insincere	negative
insincerely	negative
insincerity	negative
insinuate	negative
insinuating	negative
insinuation	negative
insinuation	negative
insist	positive
insistent	positive
insistently	positive
insociable	negative
insolence	negative
insolence	negative
insolent	negative
insolently	negative
insouciance	negative
inspiration	positive
inspirational	positive
inspire	positive
inspiring	positive
inspiring	positive
instigate	negative
instigator	negative
instigators	negative
insubstantial	negative
insubstantially	negative
insufferable	negative
insufferably	negative
insult	negative
insult	negative
insulted	negative
insulting	negative
insulting	negative
insultingly	negative
insupportable	negative
insupportably	negative
integrity	positive
intelligent	positive
intelligible	positive
interesting	positive
intimacy	positive
intimacy	positive
intimidating	negative
intimidatingly	negative
intolerable	negative
intolerablely	negative
intolerance	negative
intolerance	negative
intolerant	negative
intransigence	negative
intransigence	negative
intransigent	negative
intrigue	positive
intrigue	positive
intriguing	positive
intriguing	positive
intriguingly	positive
intrude	negative
intrusive	negative
intuitive	positive
inundate	negative
inundated	negative
invalid	negative
invalidate	negative
invalidity	negative
invaluable	positive
invaluablely	positive
invective	negative
inveigle	negative
invidious	negative
invidiously	negative
invidiousness	negative
invigorating	positive
invincibility	positive
invincible	positive
inviolable	positive
inviolate	positive
invulnerable	positive
irate	negative
irately	negative
ire	negative
irk	negative
irksome	negative
ironic	negative
ironies	negative
ironies	negative
irony	negative
irrational	negative
irrationality	negative
irrationally	negative
irreconcilable	negative
irredeemable	negative
irredeemably	negative
irreformable	negative
irrefutable	positive
irrefutably	positive
irrelevance	negative
irrelevant	negative
irreparable	negative
irreplacible	negative
irrepressible	negative
irreproachable	positive
irresistible	positive
irresistibly	positive
irresolute	negative
irresponsible	negative
irresponsibly	negative
irreverence	negative
irreverent	negative
irreverently	negative
irreversible	negative
irreversible	negative
irritable	negative
irritably	negative
irritate	negative
irritated	negative
irritating	negative
irritation	negative
irritation	negative
itch	negative
jabber	negative
jaded	negative
jaundiced	negative
jauntily	positive
jaunty	positive
jealous	negative
jealously	negative
jealousness	negative
jealousy	negative
jeer	negative
jeer	negative
jeering	negative
jeeringly	negative
jeers	negative
jeopardize	negative
jeopardy	negative
jerk	negative
jest	positive
jittery	negative
joke	positive
joke	positive
joker	negative
jolly	positive
jovial	positive
joy	positive
joyful	positive
joyfully	positive
joyless	positive
joyous	positive
joyously	positive
jubilant	positive
jubilantly	positive
jubilate	positive
jubilation	positive
jubilation	positive
judicious	positive
just	positive
justifiable	positive
justifiably	positive
justification	positive
justify	positive
justly	positive
kaput	negative
keen	positive
keen	negative
keen	negative
keenly	positive
keenness	positive
keenness	positive
kemp	positive
kick	negative
kick	negative
kid	positive
killjoy	negative
kind	positive
kindly	positive
kindliness	positive
kindness	positive
kingmaker	positive
knave	negative
knowledgeable	positive
kook	negative
kooky	negative
lack	negative
lack	negative
lackadaisical	negative
lackey	negative
lackeys	negative
lackeys	negative
lacking	negative
lackluster	negative
laconic	negative
lambast	negative
lambaste	negative
lame-duck	negative
lament	negative
lamentable	negative
lamentably	negative
languid	negative
languish	negative
languor	negative
languorous	negative
languorously	negative
lark	positive
lascivious	negative
last-ditch	negative
last-ditch	negative
laud	positive
laudable	positive
laudably	positive
laugh	negative
laugh	negative
laughable	negative
laughably	negative
laughingstock	negative
laughter	negative
lavish	positive
lavish	positive
lavishly	positive
law-abiding	positive
lawbreaker	negative
lawbreaking	negative
lawless	negative
lawlessness	negative
lawlessness	negative
lax	negative
lax	negative
lazy	negative
lech	negative
lecher	negative
lecher	negative
lecherous	negative
lechery	negative
leech	negative
leech	negative
leech	negative
leer	negative
leer	negative
leery	negative
left-leaning	negative
letch	negative
levity	positive
lewd	negative
lewdly	negative
lewdness	negative
liability	negative
liability	negative
liar	negative
liar	negative
liars	negative
liars	negative
liberate	positive
liberty	positive
licentious	negative
licentiously	negative
licentiousness	negative
lie	negative
lie	negative
lier	negative
lies	negative
lies	negative
lifeblood	positive
light-hearted	positive
likable	positive
like	positive
liking	positive
limp	negative
lionhearted	positive
listless	negative
litigious	negative
little	negative
little-known	negative
lively	positive
livid	negative
lividly	negative
loath	negative
loathe	negative
loathe	negative
loathing	negative
loathly	negative
loathsome	negative
loathsomely	negative
lofty	positive
lone	negative
lone	negative
loneliness	negative
lonely	negative
lonesome	negative
long	negative
longing	negative
longingly	negative
loophole	negative
loopholes	negative
loopholes	negative
loot	negative
lorn	negative
losing	negative
losing	negative
lousy	negative
lovable	positive
lovably	positive
love	positive
love	positive
loveless	negative
loveliness	positive
lovelorn	negative
lover	positive
lovely	positive
lovely	positive
low-rated	negative
lowly	negative
loyalty	positive
loyalty	positive
lucid	positive
lucidly	positive
luck	positive
luckier	positive
luckier	positive
luckiest	positive
luckily	positive
luckiness	positive
lucky	positive
lucky	positive
ludicrous	negative
ludicrously	negative
lugubrious	negative
lukewarm	negative
lunatic	negative
lunatic	negative
lunaticism	negative
lurch	negative
lure	negative
lurid	negative
lurk	negative
lurking	negative
lush	positive
lure	negative
luster	positive
lustrous	positive
luxuriant	positive
luxurious	positive
luxuriously	positive
luxury	positive
luxury	positive
lying	negative
lyrical	positive
macabre	negative
mad	negative
madden	negative
maddening	negative
maddeningly	negative
madder	negative
madder	negative
madly	negative
madman	negative
madness	negative
magic	positive
magical	positive
magnanimous	positive
magnanimously	positive
magnificence	positive
magnificent	positive
magnificent	positive
magnificently	positive
majestic	positive
majesty	positive
maladjusted	negative
maladjustment	negative
malcontent	negative
malcontent	negative
malcontented	negative
maledict	negative
maledict	negative
malevolence	negative
malevolent	negative
malevolently	negative
malice	negative
malicious	negative
maliciously	negative
maliciousness	negative
malign	negative
malign	negative
malodorous	negative
maltreatment	negative
maltreatment	negative
mangle	negative
mania	negative
maniac	negative
maniacal	negative
manic	negative
manifest	positive
manipulative	negative
manipulators	negative
manipulators	negative
manly	positive
mannerly	positive
mar	negative
mar	negative
martyrdom	negative
martyrdom-seeking	negative
marvel	positive
marvel	positive
marvellous	positive
marvelous	positive
marvelous	positive
marvelously	positive
marvelousness	positive
marvels	positive
massacre	negative
massacre	negative
massacres	negative
master	positive
master	positive
masterful	positive
masterfully	positive
masterpiece	positive
masterpieces	positive
masters	positive
masters	positive
mastery	positive
matchless	positive
maverick	negative
mawkish	negative
mawkishly	negative
mawkishness	negative
maxi-devaluation	negative
maxi-devaluation	negative
maximize	positive
meager	negative
mean	negative
meaningful	positive
meaningless	negative
meanness	negative
meddle	negative
meddlesome	negative
mediocre	negative
mediocrity	negative
meek	positive
melancholy	negative
mellow	positive
melodramatic	negative
melodramatically	negative
memorable	positive
memorialize	positive
menace	negative
menace	negative
menacing	negative
menacingly	negative
mendacious	negative
mendacity	negative
merciful	positive
mercifully	positive
merciless	negative
mercilessly	negative
mercy	positive
mercy	positive
mere	negative
mere	negative
merely	negative
merit	positive
merit	positive
meritorious	positive
merrily	positive
merriment	positive
merriness	positive
merry	positive
mesmerize	positive
mesmerizing	positive
mesmerizing	positive
mesmerizingly	positive
mess	negative
mess	negative
midget	negative
midget	negative
might	positive
mightily	positive
mighty	positive
militancy	negative
militancy	negative
mindful	positive
mindless	negative
mindlessly	negative
miracle	positive
miracles	positive
miraculous	positive
miraculously	positive
miraculousness	positive
mirage	negative
mirage	negative
mire	negative
mire	negative
mirth	positive
misbecoming	negative
misbecome	negative
misbegotten	negative
misbehave	negative
misbehavior	negative
mischief	negative
mischief	negative
mischievous	negative
mischievously	negative
misconception	negative
misconceptions	negative
misconceptions	negative
miscreant	negative
miscreants	negative
misdirection	negative
miser	negative
miserly	negative
miserable	negative
miserableness	negative
miserably	negative
miseries	negative
misery	negative
misery	negative
misfit	negative
misfortune	negative
misgiving	negative
misgivings	negative
misguidance	negative
misguide	negative
misguided	negative
mishandle	negative
mishap	negative
misinform	negative
misinformed	negative
misinterpret	negative
misjudge	negative
misjudgment	negative
mislead	negative
mislead	negative
misleading	negative
misleadingly	negative
mislike	negative
mismanage	negative
misread	negative
misreading	negative
misreading	negative
misrepresent	negative
misrepresentation	negative
misstatement	negative
mistake	negative
mistake	negative
mistaken	negative
mistakenly	negative
mistakes	negative
mistakes	negative
mistrust	negative
mistrust	negative
mistrustful	negative
mistrustfully	negative
misunderstand	negative
misunderstood	negative
misunderstanding	negative
misunderstanding	negative
misunderstanding	negative
misunderstandings	negative
misunderstandings	negative
misuse	negative
moan	negative
mock	negative
mock	negative
mockeries	negative
mockery	negative
mocking	negative
mockingly	negative
moderate	positive
moderation	positive
moderation	positive
molest	negative
molestation	negative
mollify	positive
momentous	positive
monotonous	negative
monotony	negative
monster	negative
monstrosities	negative
monstrosity	negative
monstrous	negative
monstrously	negative
monumental	positive
monumentally	positive
moody	negative
moral	positive
moral	positive
morality	positive
moralize	positive
morbid	negative
morbidly	negative
mordant	negative
mordantly	negative
moribund	negative
mortification	negative
mortified	negative
mortify	negative
mortifying	negative
mortifying	negative
motivate	positive
motivated	positive
motivation	positive
motivation	positive
motley	negative
mourn	negative
mourner	negative
mournful	negative
mournfully	negative
moving	positive
mudslinger	negative
mudslinging	negative
mulish	negative
multi-polarization	negative
multi-polarization	negative
mundane	negative
muscle-flexing	negative
mysterious	negative
mysteriously	negative
mystery	negative
myth	negative
myth	negative
nag	negative
nagging	negative
naive	negative
naively	negative
narrower	negative
narrower	negative
nastily	negative
nastiness	negative
nasty	negative
nationalism	negative
nationalism	negative
naughty	negative
nauseating	negative
nauseatingly	negative
nebulous	negative
nebulous	negative
nebulously	negative
nefarious	negative
nefariously	negative
neglect	negative
neglect	negative
neglected	negative
negligent	negative
negligence	negative
nemesis	negative
nettlesome	negative
nervous	negative
nervously	negative
nervousness	negative
neurotic	negative
neurotically	negative
nice	positive
nicely	positive
nifty	positive
nightmare	negative
nightmarish	negative
nightmarishly	negative
nimble	positive
nix	negative
noble	positive
nobly	positive
non-confidence	negative
non-confidence	negative
nonsense	negative
nosey	negative
notable	positive
notable	positive
notably	positive
noteworthy	positive
noteworthy	positive
notorious	negative
notoriously	negative
novel	positive
nuisance	negative
nuisance	negative
nurture	positive
nurturing	positive
nurturing	positive
oasis	positive
obedience	positive
obedient	positive
obediently	positive
obey	positive
obese	negative
obese	negative
object	negative
objection	negative
objection	negative
objectionable	negative
objections	negative
objections	negative
obliged	positive
obliterate	negative
obliterated	negative
oblivious	negative
oblivious	negative
obnoxious	negative
obnoxiously	negative
obscene	negative
obscenely	negative
obscenity	negative
obscure	negative
obscurity	negative
obsess	negative
obsession	negative
obsessions	negative
obsessive	negative
obsessively	negative
obsessiveness	negative
obstacle	negative
obstacle	negative
obstinate	negative
obstinately	negative
obtrusive	negative
obtuse	negative
obviate	positive
obviously	negative
odder	negative
oddest	negative
oddities	negative
oddities	negative
oddity	negative
oddly	negative
offbeat	positive
offend	negative
offend	negative
offending	negative
offenses	negative
offenses	negative
offensively	negative
offensiveness	negative
officious	negative
okay	positive
ominous	negative
ominously	negative
one-side	negative
one-sided	negative
onerous	negative
onerously	negative
opinionated	negative
opponent	negative
opportune	positive
opportunity	positive
oppose	negative
opposition	negative
opposition	negative
oppositions	negative
oppositions	negative
oppress	negative
oppression	negative
oppression	negative
oppressive	negative
oppressively	negative
oppressiveness	negative
oppressors	negative
oppressors	negative
optimal	positive
optimism	positive
opulent	positive
ordeal	negative
ostracize	negative
outburst	negative
outburst	negative
outbursts	negative
outbursts	negative
outcast	negative
outcry	negative
outdo	positive
outlaw	negative
outrage	negative
outrage	negative
outraged	negative
outrageous	negative
outrageous	negative
outrageously	negative
outrageousness	negative
outrages	negative
outshine	positive
outsmart	positive
outstanding	positive
outstandingly	positive
outstrip	positive
outwit	positive
ovation	positive
ovation	positive
over-acted	negative
overachiever	positive
overact	negative
overact	negative
overacted	negative
overbearing	negative
overbearingly	negative
overblown	negative
overcome	negative
overdo	negative
overdone	negative
overdue	negative
overemphasize	negative
overjoyed	positive
overkill	negative
overlook	negative
overplay	negative
overstate	negative
overstatement	negative
overstatement	negative
overstatements	negative
overture	positive
overture	positive
overwhelming	negative
overwhelmingly	negative
overworked	negative
overzealous	negative
overzealously	negative
pacifist	positive
pacifists	positive
pacifists	positive
pain	negative
pain	negative
pains	negative
pains	negative
painstaking	positive
painstakingly	positive
palatable	positive
palatial	positive
palliate	positive
paltry	negative
pandemonium	negative
panic	negative
panic	negative
panicky	negative
paradise	positive
paradoxical	negative
paradoxically	negative
paramount	positive
paranoia	negative
paranoid	negative
pardon	positive
pariah	negative
parody	negative
partiality	negative
partiality	negative
partisan	negative
partisan	negative
partisans	negative
partisans	negative
passe	negative
passion	positive
passionate	positive
passionately	positive
passive	negative
passiveness	negative
passiveness	negative
pathetic	negative
pathetically	negative
patience	positive
patiently	positive
patriot	positive
patriotic	positive
patronize	negative
paucity	negative
paucity	negative
pauper	negative
paupers	negative
paupers	negative
payback	negative
payback	negative
peaceable	positive
peculiar	negative
peculiarly	negative
pedantic	negative
peerless	positive
peeve	negative
peeved	negative
peevish	negative
peevishly	negative
penalize	negative
penetrating	positive
penitent	positive
perceptive	positive
perfect	positive
perfect	positive
perfect	positive
perfection	positive
perfectly	positive
perfidious	negative
perfidity	negative
perfunctory	negative
perfunctory	negative
peril	negative
perish	negative
pernicious	negative
perplex	negative
perplexed	negative
perplexing	negative
perplexity	negative
persecute	negative
persecution	negative
persecution	negative
perseverance	positive
persevere	positive
personality	positive
personality	positive
perspicuous	positive
perspicuously	positive
persuade	positive
persuasive	positive
persuasive	positive
persuasively	positive
pertinacious	negative
pertinaciously	negative
pertinacity	negative
perturb	negative
perturbed	negative
pervasive	negative
pervasive	negative
perverse	negative
perversely	negative
perversion	negative
perversity	negative
pervert	negative
perverted	negative
pessimism	negative
pessimistic	negative
pessimistically	negative
pest	negative
pestilent	negative
petrify	negative
petrified	negative
pettifog	negative
petty	negative
phenomenal	positive
phenomenally	positive
phobia	negative
phobic	negative
phony	negative
picky	negative
picturesque	positive
pillage	negative
pillar	positive
pillar	positive
pillory	negative
pine	negative
pinnacle	positive
pious	positive
pithy	positive
pithy	positive
pitiable	negative
pitiful	negative
pitifully	negative
pitiless	negative
pitilessly	negative
pittance	negative
pity	negative
pity	negative
placate	positive
plagiarize	negative
plague	negative
plague	negative
plainly	positive
plausibility	positive
plausible	positive
playful	positive
playfully	positive
plaything	negative
plaything	negative
pleas	negative
pleas	negative
please	positive
pleased	positive
pleasing	positive
pleasingly	positive
pleasurable	positive
pleasurably	positive
pleasure	positive
pleasure	positive
plebeian	negative
pledge	positive
pledge	positive
pledges	positive
pledges	positive
plenty	positive
plight	negative
plot	negative
plotters	negative
plotters	negative
ploy	negative
ploy	negative
plunder	negative
plunderer	negative
plush	positive
poetic	positive
poeticize	positive
poignant	positive
poise	positive
poised	positive
poison	negative
poison	negative
polarisation	negative
polarisation	negative
polemize	negative
polluter	negative
polluter	negative
polluters	negative
polluters	negative
pompous	negative
poorly	negative
posh	positive
positiveness	positive
positively	positive
posturing	negative
posturing	negative
potent	positive
pout	negative
poverty	negative
pragmatic	positive
praise	positive
praise	positive
praiseworthy	positive
praising	positive
praising	positive
prate	negative
pratfall	negative
prattle	negative
preach	positive
preaching	positive
preaching	positive
precaution	positive
precautions	positive
precious	positive
precious	positive
precipitate	negative
precipitous	negative
predicament	negative
prefer	positive
preferable	positive
preferable	positive
preferably	positive
preference	positive
preferences	positive
preferences	positive
prejudge	negative
prejudice	negative
prejudice	negative
prejudicial	negative
premeditated	negative
preponderance	positive
preponderance	positive
preposterous	negative
preposterously	negative
pressing	negative
pressing	negative
prestige	positive
presume	negative
presumptuous	negative
presumptuous	negative
presumptuously	negative
pretence	negative
pretence	negative
pretend	negative
pretense	negative
pretense	negative
pretentious	negative
pretentiously	negative
prettily	positive
pretty	positive
prevaricate	negative
priceless	positive
prickle	negative
prickles	negative
prickles	negative
pride	positive
prideful	negative
privilege	positive
privileged	positive
prize	positive
pro-American	positive
pro-American	positive
pro-Beijing	positive
pro-Beijing	positive
pro-Cuba	positive
pro-Cuba	positive
pro-peace	positive
pro-peace	positive
proactive	positive
proactive	positive
problematic	negative
problematic	negative
procrastinate	negative
procrastination	negative
prodigious	positive
prodigiously	positive
prodigy	positive
profane	negative
profane	negative
profanity	negative
profess	positive
proficient	positive
proficiently	positive
profound	positive
profoundly	positive
profuse	positive
profusely	positive
profusion	positive
promise	positive
promise	positive
promising	positive
promoter	positive
promoter	positive
propaganda	negative
propaganda	negative
propagandize	negative
propitious	positive
propitiously	positive
proscription	negative
proscription	negative
proscriptions	negative
proscriptions	negative
prosecute	negative
prosper	positive
protector	positive
protector	positive
protest	negative
protest	negative
protest	negative
proud	positive
providence	positive
provocation	negative
provocation	negative
provocative	negative
provocative	negative
provoke	negative
prowess	positive
prudent	positive
prudently	positive
pugnacious	negative
pugnaciously	negative
pugnacity	negative
punch	negative
punch	negative
punctual	positive
pundits	positive
pundits	positive
punish	negative
puny	negative
puppet	negative
puppet	negative
puppets	negative
puppets	negative
purposeful	positive
puzzle	negative
puzzled	negative
puzzlement	negative
puzzling	negative
quack	negative
quaint	positive
qualms	negative
qualms	negative
quandary	negative
quarrel	negative
quarrellous	negative
quarrellously	negative
quarrels	negative
quarrelsome	negative
quash	negative
quasi-ally	positive
quasi-ally	positive
questionable	negative
questionable	negative
quibble	negative
quicken	positive
quitter	negative
racist	negative
racist	negative
racist	negative
racists	negative
racists	negative
rack	negative
radiance	positive
radiant	positive
radical	negative
radical	negative
radical	negative
radicalization	negative
radicalization	negative
radically	negative
radicals	negative
rage	negative
rage	negative
ragged	negative
raging	negative
rail	negative
rally	positive
rampage	negative
rampant	negative
ramshackle	negative
rancor	negative
rank	negative
rankle	negative
rant	negative
rant	negative
ranting	negative
rantingly	negative
rapport	positive
rapt	positive
rapture	positive
rapture	positive
raptureous	positive
raptureously	positive
rapturous	positive
rapturously	positive
rascal	negative
rash	negative
rational	positive
rationalize	negative
rattle	negative
ravage	negative
rave	positive
raving	negative
re-conquest	positive
re-conquest	positive
reactionary	negative
realist	positive
realistic	positive
realistically	positive
reassurance	positive
reassurance	positive
reassure	positive
rebellious	negative
rebuff	negative
rebuke	negative
recalcitrant	negative
recant	negative
receptive	positive
reckless	negative
recklessly	negative
recklessness	negative
recoil	negative
recommend	positive
recommendation	positive
recommendations	positive
recommendations	positive
recommended	positive
rectification	positive
rectification	positive
rectify	positive
rectifying	positive
rectifying	positive
redeem	positive
redeeming	positive
redemption	positive
refreshing	positive
refuge	positive
refuse	negative
refutation	negative
refutation	negative
refute	negative
regal	positive
regally	positive
regard	positive
regret	negative
regret	negative
regret	negative
regretful	negative
regretfully	negative
regrettable	negative
regrettably	negative
reject	negative
rejection	negative
rejection	negative
rejoice	positive
rejoicing	positive
rejoicingly	positive
relent	positive
relentless	negative
relentlessly	negative
relentlessness	negative
relief	positive
relief	positive
relish	positive
reluctance	negative
reluctance	negative
remarkable	positive
remarkable	positive
remarkably	positive
reminiscent	positive
reminiscent	positive
remorse	negative
remorse	negative
remorseful	negative
remorseful	negative
remorsefully	negative
remorseless	negative
remorselessly	negative
remorselessness	negative
remunerate	positive
renaissance	positive
renounce	negative
renown	positive
renowned	positive
renunciation	negative
repay	positive
repent	positive
repentance	positive
reprehensible	negative
reprehensible	negative
reprehensibly	negative
reprehension	negative
reprehensive	negative
reprimand	negative
reproach	negative
reproach	negative
reproach	negative
reproachful	negative
reprove	negative
reprovingly	negative
repudiate	negative
repudiation	negative
repudiation	negative
repugn	negative
repugnance	negative
repugnant	negative
repugnantly	negative
repulsing	negative
repulsive	negative
repulsively	negative
repulsiveness	negative
resent	negative
resentful	negative
resentment	negative
resentment	negative
resounding	positive
resourceful	positive
resourcefulness	positive
respect	positive
respect	positive
respectable	positive
respectful	positive
respectfully	positive
respite	positive
resplendent	positive
reticent	negative
revel	positive
revel	positive
revel	positive
revenge	negative
revenge	negative
revengeful	negative
revengefully	negative
revere	positive
reverence	positive
reverent	positive
reverently	positive
revile	negative
reviled	negative
revolting	negative
revoltingly	negative
revulsion	negative
revulsive	negative
reward	positive
rewarding	positive
rewardingly	positive
rhetorical	negative
rhetorical	negative
richly	positive
richness	positive
rid	negative
ridicule	negative
ridicule	negative
ridiculous	negative
ridiculously	negative
rife	negative
rift	negative
rift	negative
rifts	negative
rifts	negative
right	positive
righten	positive
righteous	positive
righteously	positive
righteousness	positive
rightful	positive
rightfully	positive
rightly	positive
rightness	positive
rightness	positive
rile	negative
riled	negative
roadblocks	negative
roadblocks	negative
rogue	negative
rogue	negative
rollercoaster	negative
rollercoaster	negative
romantic	positive
romantically	positive
romanticize	positive
rosy	positive
rotten	negative
rousing	positive
rubbish	negative
rude	negative
rue	negative
rue	negative
ruffian	negative
rumbling	negative
rumbling	negative
rumor	negative
rumor	negative
rumors	negative
rumors	negative
rumours	negative
rumours	negative
rumple	negative
run-down	negative
runaway	negative
rusty	negative
ruthless	negative
ruthlessly	negative
ruthlessness	negative
sabotage	negative
sacred	positive
sacrifice	negative
sacrifice	negative
sad	negative
sad	negative
sadden	negative
sadly	negative
sadness	negative
safeguard	positive
sagacity	positive
sage	positive
sagely	positive
saint	positive
saintliness	positive
saintly	positive
salacious	negative
salutary	positive
salute	positive
salvation	positive
sanctimonious	negative
sanctimonious	negative
sanctify	positive
sanction	positive
sanctity	positive
sanctuary	positive
sanctuary	positive
sanguine	positive
sane	positive
sanity	positive
sanity	positive
sap	negative
sarcasm	negative
sarcastic	negative
sarcastically	negative
sardonic	negative
sardonically	negative
sass	negative
sass	negative
satirical	negative
satirize	negative
satisfaction	positive
satisfaction	positive
satisfactorily	positive
satisfactory	positive
savage	negative
savage	negative
savage	negative
savaged	negative
savagely	negative
savagery	negative
savages	negative
savvy	positive
scandalize	negative
scandalized	negative
scandalous	negative
scandalously	negative
scandals	negative
scapegoat	negative
scar	negative
scar	negative
scarred	negative
scarcely	negative
scare	negative
scared	negative
scarier	negative
scariest	negative
scarily	negative
scars	negative
scars	negative
scary	negative
scary	negative
scathing	negative
scathingly	negative
scheming	negative
scoff	negative
scoffingly	negative
scold	negative
scolding	negative
scoldingly	negative
scorching	negative
scorchingly	negative
scorn	negative
scornful	negative
scornfully	negative
scoundrel	negative
scourge	negative
scowl	negative
scowl	negative
scream	negative
screech	negative
screech	negative
scruples	positive
scrupulous	positive
scrupulously	positive
scum	negative
scummy	negative
seamless	positive
second-class	negative
seductive	positive
seedy	negative
seethe	negative
seething	negative
self-coup	negative
self-coup	negative
self-criticism	negative
self-criticism	negative
self-destructive	negative
self-determination	positive
self-determination	positive
self-humiliation	negative
self-humiliation	negative
self-interest	negative
self-interest	negative
self-interested	negative
self-respect	positive
self-satisfaction	positive
self-satisfaction	positive
self-serving	negative
self-serving	negative
selfinterested	negative
selfish	negative
selfishly	negative
selfishness	negative
senile	negative
sensation	positive
sensation	positive
sensational	positive
sensationalize	negative
sensationally	positive
sensations	positive
sensations	positive
senseless	negative
senselessly	negative
sensible	positive
sensibly	positive
sensitively	positive
sensitivity	positive
sensitivity	positive
sentiment	positive
sentiment	positive
sentimentality	positive
sentimentally	positive
sentiments	positive
serene	positive
serenity	positive
serious	negative
seriously	negative
seriousness	negative
sermonize	negative
servitude	negative
set-up	negative
set-up	negative
severe	negative
severely	negative
severity	negative
sexy	positive
shabby	negative
shadow	negative
shady	negative
sham	negative
shambles	negative
shame	negative
shame	negative
shameful	negative
shameful	negative
shamefully	negative
shamefully	negative
shamefulness	negative
shameless	negative
shamelessly	negative
shamelessness	negative
shark	negative
shatter	negative
sheer	negative
shimmer	positive
shimmering	positive
shimmeringly	positive
shiny	positive
shirk	negative
shirker	negative
shiver	negative
shock	negative
shock	negative
shock	negative
shocking	negative
shockingly	negative
shoddy	negative
shortchange	negative
shortcoming	negative
shortcomings	negative
shortsighted	negative
shortsightedness	negative
shrew	negative
shrewd	positive
shrewdly	positive
shrewdness	positive
shriek	negative
shrill	negative
shrill	negative
shrilly	negative
shrivel	negative
shroud	negative
shrouded	negative
shun	negative
shunned	negative
shy	negative
shyly	negative
shyness	negative
sickly	negative
sickening	negative
sickening	negative
sickeningly	negative
sidetrack	negative
sidetracked	negative
sillily	negative
silly	negative
simmer	negative
simplicity	positive
simplistic	negative
simplistic	negative
simplistically	negative
sin	negative
sin	negative
sinful	negative
sinfully	negative
sincere	positive
sincerely	positive
sinister	negative
sinisterly	negative
skeletons	negative
skeletons	negative
skeptical	negative
skeptical	negative
skeptically	negative
skepticism	negative
skepticism	negative
skillful	positive
skillful	positive
skillfully	positive
skittish	negative
skittish	negative
skittishly	negative
skulk	negative
slander	negative
slander	negative
slanderer	negative
slanderous	negative
slanderously	negative
slanders	negative
slanders	negative
slap	negative
slashing	negative
slashing	negative
slaves	negative
slaves	negative
sleazy	negative
slime	negative
sloppy	negative
sloppily	negative
sloth	negative
slothful	negative
slur	negative
sly	negative
smack	negative
smack	negative
smart	positive
smart	positive
smarter	positive
smartest	positive
smartly	positive
smile	positive
smile	positive
smiling	positive
smilingly	positive
smitten	positive
smokescreen	negative
smokescreen	negative
smolder	negative
smoldering	negative
smother	negative
smoulder	negative
smouldering	negative
smug	negative
smugly	negative
smut	negative
smuttier	negative
smuttiest	negative
smutty	negative
sneer	negative
sneer	negative
sneering	negative
sneeringly	negative
snub	negative
so-cal	negative
so-called	negative
sob	negative
sober	negative
sobering	negative
sociable	positive
soften	positive
soften	positive
soften	positive
solace	positive
solicitous	positive
solicitously	positive
solicitude	positive
solidarity	positive
solidarity	positive
somber	negative
soothe	positive
soothingly	positive
sophisticated	positive
sore	negative
sore	negative
sorely	negative
sorrow	negative
sorrowful	negative
sorrowfully	negative
sorry	negative
spade	negative
spade	negative
spank	negative
sparkle	positive
spectacular	positive
spectacularly	positive
spellbind	positive
spellbinding	positive
spellbindingly	positive
spellbound	positive
spilling	negative
spilling	negative
spiritless	negative
spiritual	positive
spiritual	positive
spite	negative
spiteful	negative
spitefully	negative
spitefulness	negative
splendid	positive
splendidly	positive
splendor	positive
spoil	negative
spook	negative
spookier	negative
spookiest	negative
spookily	negative
spooky	negative
spooky	negative
spoon-fed	negative
spoon-feed	negative
spoonfed	negative
spotless	positive
sprightly	positive
spur	positive
spurious	negative
spurn	negative
sputter	negative
squabble	negative
squabbling	negative
squander	negative
squarely	positive
squash	negative
squirm	negative
staggering	negative
staggeringly	negative
stagnate	negative
stagnation	negative
staid	negative
stale	negative
stalemate	negative
stammer	negative
standstill	negative
star	positive
star	positive
stark	negative
starkly	negative
stars	positive
stars	positive
startle	negative
startling	negative
startlingly	negative
stately	positive
statuesque	positive
staunch	positive
staunchly	positive
staunchness	positive
steadfast	positive
steadfastly	positive
steadfastness	positive
stellar	positive
stellarly	positive
stench	negative
stereotype	negative
stereotypical	negative
stereotypically	negative
stern	negative
stern	negative
stew	negative
stifle	negative
stifling	negative
stiflingly	negative
stigma	negative
stigma	negative
stigmatize	negative
stimulating	positive
sting	negative
stinging	negative
stingingly	negative
stink	negative
stink	negative
stinking	negative
stirring	positive
stirringly	positive
stodgy	negative
stooge	negative
stooges	negative
stooges	negative
straightforward	positive
strange	negative
strange	negative
strangely	negative
stranger	negative
strangest	negative
stress	negative
stress	negative
stressful	negative
stressfully	negative
stricken	negative
strict	negative
strictly	negative
stride	positive
stride	positive
strident	negative
stridently	negative
strife	negative
striking	positive
strikingly	positive
striving	positive
striving	positive
struggle	negative
struggle	negative
strut	negative
stubborn	negative
stubbornly	negative
stubbornness	negative
studious	positive
studiously	positive
stuffy	negative
stunned	positive
stunning	positive
stunningly	positive
stupendous	positive
stupendously	positive
stupid	negative
stupidity	negative
stupidly	negative
stupified	negative
stupify	negative
stupor	negative
sty	negative
sty	negative
stylish	positive
stylishly	positive
suave	positive
subjugate	negative
subjugate	negative
subjugation	negative
sublime	positive
subservience	negative
subservient	negative
succumb	negative
sucker	negative
sufferer	negative
sufferers	negative
sufferers	negative
suffering	negative
suffering	negative
suffocate	negative
sugar-coat	negative
sugar-coated	negative
sugarcoated	negative
sulk	negative
sullen	negative
sully	negative
sumptuous	positive
sumptuously	positive
sumptuousness	positive
sunder	negative
super	positive
superb	positive
superbly	positive
superficial	negative
superficial	negative
superficiality	negative
superficially	negative
superfluous	negative
superiority	negative
superiority	negative
superlative	positive
superstition	negative
superstitious	negative
support	positive
support	positive
supporter	positive
supporter	positive
supportive	positive
supportive	positive
supremacy	negative
supremacy	negative
supreme	positive
supremely	positive
supurb	positive
supurbly	positive
sure	positive
surely	positive
surge	positive
surging	positive
surmise	positive
surmount	positive
surpass	positive
suspicions	negative
suspicions	negative
suspicious	negative
suspicious	negative
suspicious	negative
suspiciously	negative
swagger	negative
swamped	negative
swear	negative
sweeping	positive
swindle	negative
swipe	negative
swipe	negative
swore	negative
sworn	positive
sympathetic	negative
sympathetic	negative
sympathetically	negative
sympathies	negative
sympathies	negative
sympathize	negative
sympathy	negative
sympathy	negative
taboo	negative
taboo	negative
tact	positive
taint	negative
tainted	negative
talent	positive
talent	positive
talented	positive
tantalizing	positive
tantalizingly	positive
tantrum	negative
tattered	negative
taunt	negative
taunt	negative
taunting	negative
tauntingly	negative
taunts	negative
tawdry	negative
teasingly	negative
tedious	negative
tediously	negative
temerity	negative
temper	negative
tempt	positive
temptation	negative
tempting	positive
temptingly	positive
tenacious	positive
tenaciously	positive
tenacity	positive
terrible	negative
terrible	negative
terribleness	negative
terribly	negative
terrific	positive
terrific	positive
terrifically	positive
terrified	positive
terrify	positive
terrifying	positive
terrifying	positive
terrifyingly	positive
terror	negative
terror-genic	negative
terror-genic	negative
terrorize	negative
thank	positive
thankful	positive
thankfully	positive
thankless	negative
thinkable	positive
thinkable	positive
thirst	negative
thirst	negative
thorny	negative
thorny	negative
thoughtful	positive
thoughtfully	positive
thoughtfulness	positive
thoughtless	negative
thoughtlessly	negative
thoughtlessness	negative
thrill	positive
thrill	positive
thrilling	positive
thrillingly	positive
thrills	positive
throttle	negative
thwart	negative
tidy	positive
time-honored	positive
timid	negative
timidity	negative
timidly	negative
timidness	negative
tingle	positive
tired	negative
tiresome	negative
tiring	negative
tiring	negative
tiringly	negative
titillating	positive
titillatingly	positive
toast	positive
togetherness	positive
toil	negative
tolerable	positive
tolerably	positive
tolerance	positive
tolerance	positive
tolerantly	positive
torment	negative
torment	negative
tormented	negative
torrent	negative
torrid	positive
torridly	positive
tortuous	negative
torturous	negative
torturously	negative
touchy	negative
toughness	negative
toughness	negative
traduce	negative
tragic	negative
tragically	negative
traitor	negative
traitorous	negative
traitorously	negative
traitorously	negative
tramp	negative
trample	negative
tranquil	positive
tranquility	positive
tranquility	positive
trauma	negative
trauma	negative
traumatic	negative
traumatic	negative
traumatically	negative
traumatize	negative
traumatized	negative
travesties	negative
travesty	negative
travesty	negative
treachery	negative
treason	negative
treasonous	negative
treasure	positive
tremendous	positive
tremendously	positive
trendy	positive
trepidation	positive
tribute	positive
trick	negative
trick	negative
tricky	negative
tricky	negative
trickery	negative
triumph	positive
triumph	positive
triumphal	positive
triumphant	positive
triumphant	positive
triumphantly	positive
trivial	negative
trivial	negative
trivialize	negative
trivially	negative
trouble	negative
troublemaker	negative
troublemaker	negative
troublesome	negative
troublesome	negative
troublesomely	negative
troubling	negative
troublingly	negative
truculent	positive
truculently	positive
true	positive
truly	positive
trump	positive
trumpet	positive
trusting	positive
trustingly	positive
trustworthiness	positive
trustworthy	positive
truth	positive
truthful	positive
truthfully	positive
truthfulness	positive
turmoil	negative
twinkly	positive
twist	negative
twist	negative
twisted	negative
tyrannical	negative
tyrannically	negative
tyranny	negative
tyrant	negative
ugh	negative
ugliness	negative
ugliness	negative
ugly	negative
ulterior	negative
ultimate	positive
ultimately	positive
ultimatum	negative
ultimatums	negative
ultimatums	negative
ultra	positive
ultra-hardline	negative
ultra-hardline	negative
unabashed	positive
unabashedly	positive
unacceptable	negative
unacceptablely	negative
unanimous	positive
unassailable	positive
unassailable	positive
unattractive	negative
unbearable	negative
unbearablely	negative
unbelievable	negative
unbelievably	negative
unbosom	positive
uncivil	negative
uncivilized	negative
uncivilized	negative
unclean	negative
uncommon	positive
uncommonly	positive
uncompromising	negative
uncompromisingly	negative
unconcerned	positive
unconvincing	negative
unconvincingly	negative
uncouth	negative
undaunted	positive
undependability	negative
undependable	negative
underdog	negative
underdog	negative
underestimate	negative
underlings	negative
underlings	negative
undermine	negative
understand	positive
understandable	positive
understood	positive
understate	positive
understated	positive
understatedly	positive
undesirable	negative
undignified	negative
undisputable	positive
undisputably	positive
undoubted	positive
undoubtedly	positive
undue	negative
unease	negative
unease	negative
uneasily	negative
uneasiness	negative
uneasiness	negative
uneasy	negative
unequal	negative
unequivocal	positive
unequivocal	positive
unequivocally	positive
unethical	negative
unexpectedly	negative
unfair	negative
unfairly	negative
unfaithful	negative
unfaithfully	negative
unfavorable	negative
unfazed	positive
unfeeling	negative
unfettered	positive
unfit	negative
unforgettable	positive
unfortunate	negative
unfortunately	negative
unfounded	negative
unfriendly	negative
ungrateful	negative
ungovernable	negative
ungovernable	negative
unhappily	negative
unhappiness	negative
unhappy	negative
unilateralism	negative
unilateralism	negative
unimaginable	negative
unimaginably	negative
unimportant	negative
unipolar	negative
unipolar	negative
unjust	negative
unjustifiable	negative
unjustifiably	negative
unjustly	negative
unkind	negative
unkindly	negative
unlamentable	negative
unlamentably	negative
unleash	negative
unlucky	negative
unnaturally	negative
unnerve	negative
unnerved	negative
unnerving	negative
unnervingly	negative
unorthodox	negative
unorthodoxy	negative
unparalleled	positive
unpleasant	negative
unpleasantries	negative
unpleasantries	negative
unpopular	negative
unprecedent	negative
unprecedented	negative
unpretentious	positive
unqualified	negative
unquestionable	positive
unquestionably	positive
unravel	negative
unravel	negative
unrealistic	negative
unreasonable	negative
unreasonably	negative
unrelenting	negative
unrelenting	negative
unrelentingly	negative
unreliability	negative
unreliability	negative
unreliable	negative
unrest	negative
unruly	negative
unsavory	negative
unscrupulous	negative
unscrupulously	negative
unseemly	negative
unselfish	positive
unsettle	negative
unsettling	negative
unsettlingly	negative
unsophisticated	negative
unsound	negative
unspeakable	negative
unspeakablely	negative
unsuspecting	negative
untenable	negative
unthinkable	negative
unthinkably	negative
untimely	negative
untrue	negative
untrustworthy	negative
untruthful	negative
unusually	negative
unwanted	negative
unwarranted	negative
unwelcome	negative
unwieldy	negative
unwilling	negative
unwillingly	negative
unwillingness	negative
unwise	negative
unwisely	negative
unworkable	negative
unworthy	negative
unyielding	negative
upbeat	positive
upbraid	negative
upheaval	negative
upheld	positive
uphold	positive
uplifting	positive
upliftingly	positive
upliftment	positive
upliftment	positive
uproar	negative
uproarious	negative
uproariously	negative
uproarous	negative
uproarously	negative
upsetting	negative
upsetting	negative
upsettingly	negative
upside	positive
upside	positive
urge	positive
urgency	negative
urgency	negative
usurp	negative
usurper	negative
utmost	positive
utter	negative
utterly	negative
uttermost	positive
vagrant	negative
vain	negative
vainly	negative
valiant	positive
valiantly	positive
valor	positive
valuable	positive
vanquish	positive
vehement	negative
vehemently	negative
venerable	positive
venerably	positive
vengeance	negative
vengeful	negative
vengefully	negative
vengefulness	negative
venom	negative
venom	negative
venomous	negative
venomously	negative
vent	negative
vent	negative
veritable	positive
vestiges	negative
vestiges	negative
veto	negative
veto	negative
vex	negative
vex	negative
vexation	negative
vexing	negative
vexingly	negative
vibrant	positive
vibrantly	positive
vice	negative
vicious	negative
viciously	negative
viciousness	negative
victimize	negative
vie	negative
vile	negative
vileness	negative
vilify	negative
villainous	negative
villainously	negative
villains	negative
villains	negative
villian	negative
villianous	negative
villianously	negative
villify	negative
vindicate	positive
vindictive	negative
vindictively	negative
vindictiveness	negative
violate	negative
violator	negative
violator	negative
virtue	positive
virtuous	positive
virtuously	positive
virulence	negative
virulent	negative
virulently	negative
virus	negative
virus	negative
visionary	positive
vital	positive
vitality	positive
vitality	positive
vivacious	positive
vivid	positive
vociferous	negative
vociferously	negative
vouch	positive
vouchsafe	positive
vow	positive
vulgar	negative
vulnerable	negative
vulnerable	negative
wail	negative
waning	negative
waning	negative
want	positive
wanton	negative
war-like	negative
war-like	negative
warlike	negative
warmhearted	positive
warmly	positive
wary	negative
warily	negative
wariness	negative
watchdog	negative
watchdog	negative
wayward	negative
weaken	negative
weakening	negative
weakening	negative
weakness	negative
weakness	negative
weaknesses	negative
weaknesses	negative
weariness	negative
wearisome	negative
weary	negative
weary	negative
wee	negative
weird	negative
weird	negative
weirdly	negative
welcome	positive
welcome	positive
welcome	positive
well-being	positive
well-being	positive
well-connected	positive
well-informed	positive
well-intentioned	positive
well-managed	positive
well-received	positive
well-regarded	positive
well-run	positive
well-wishers	positive
well-wishers	positive
wellbeing	positive
wellbeing	positive
wheedle	negative
whimper	negative
whimsical	positive
whine	negative
whine	negative
whips	negative
whips	negative
wholeheartedly	positive
wholesome	positive
wicked	negative
wickedly	negative
wickedness	negative
wiles	negative
will	positive
will	positive
willful	positive
willfully	positive
willing	positive
willingness	positive
willingness	positive
wilt	negative
wily	negative
wince	negative
wink	positive
wink	positive
winnable	positive
winnable	positive
winners	positive
winners	positive
wisdom	positive
wisdom	positive
wise	positive
wise	positive
wisely	positive
wish	positive
wish	positive
wish	positive
wishes	positive
wishes	positive
wishing	positive
wishing	positive
witty	positive
woe	negative
woebegone	negative
woeful	negative
woefully	negative
wonder	positive
wonderful	positive
wonderful	positive
wonderfully	positive
wonderous	positive
wonderously	positive
wondrous	positive
woo	positive
workable	positive
world-famous	positive
worried	negative
worriedly	negative
worrier	negative
worries	negative
worries	negative
worrisome	negative
worry	negative
worry	negative
worry	negative
worrying	negative
worryingly	negative
worse	negative
worsen	negative
worsening	negative
worst	negative
worth	positive
worth	positive
worth-while	positive
worthiness	positive
worthless	negative
worthlessly	negative
worthlessness	negative
worthwhile	positive
worthy	positive
wound	negative
wound	negative
wow	positive
wow	positive
wrangle	negative
wrath	negative
wrest	negative
wretch	negative
wretched	negative
wretchedly	negative
wretchedness	negative
wrongly	negative
wry	positive
yawn	negative
yawn	negative
yearn	positive
yearning	positive
yearningly	positive
yelp	negative
yep	positive
yes	positive
zeal	positive
zealot	negative
zealous	negative
zealously	negative
zenith	positive
zest	positive
